//1,2,3,4,5,6,7,8,9,1-Jan,11,12,13,14,15,16,17,18,19,2-Jan,21,22,23,24,25,26,27,28,29,3-Jan,31,32
0,0,0,0,0,5,5,5,5,5,5,5,5,5,5,5,5,5,5,5,5,5,5,5,5,5,5,5,5,5,0,0
0,0,0,0,0,5,0,0,0,0,0,0,0,0,0,0,0,0,0,0,0,0,0,0,0,0,0,0,0,5,0,0
0,0,0,0,0,5,0,0,0,0,0,0,0,0,0,0,0,0,0,0,0,0,0,0,0,0,0,0,0,5,0,0
0,0,0,0,0,5,0,0,0,0,0,0,0,0,0,0,0,0,0,0,0,0,0,0,0,0,0,0,0,5,0,0
0,0,0,0,0,5,0,0,0,0,0,0,0,0,0,0,0,0,0,0,0,0,0,0,0,0,0,0,0,5,0,0
0,0,0,0,0,5,0,0,0,0,0,0,0,0,0,0,0,0,0,0,0,0,0,0,0,0,0,0,0,5,0,0
0,0,0,0,0,5,0,0,0,0,0,0,0,0,0,0,0,0,0,0,0,0,0,0,0,0,0,0,0,5,0,0
0,0,0,0,0,5,0,0,0,0,0,0,5,0,0,0,0,0,0,5,0,0,5,0,0,0,0,0,0,5,0,0
0,0,0,0,0,5,0,0,0,0,0,0,5,0,0,0,0,0,0,5,0,0,5,0,0,0,0,0,0,5,0,0
0,0,0,0,0,5,0,0,15,0,0,0,5,0,0,0,0,0,0,5,0,0,5,0,0,0,5,0,0,5,0,0
0,0,0,0,0,5,0,0,0,0,0,0,5,0,0,0,0,0,0,5,0,0,5,0,0,0,5,0,0,5,0,0
0,0,0,0,0,5,0,0,0,0,0,0,5,0,0,0,0,0,0,5,0,0,5,0,0,0,5,0,0,5,0,0
0,0,0,0,0,5,0,0,0,0,0,0,5,0,0,0,0,0,0,5,0,0,5,0,0,0,5,0,0,5,0,0
0,0,0,0,0,5,0,0,0,0,0,0,5,0,0,0,0,0,0,5,0,0,5,0,0,0,5,0,0,5,0,0
0,0,0,0,0,5,0,0,0,0,0,0,5,0,0,0,0,0,0,5,0,0,5,0,0,0,5,0,0,5,0,0
0,0,0,0,0,5,0,0,0,0,0,0,5,0,0,0,0,0,0,5,0,0,0,0,0,0,5,0,0,5,0,0
0,0,0,0,0,5,0,0,0,0,0,0,0,5,5,5,5,5,5,0,0,0,0,0,0,0,5,0,0,5,0,0
0,0,0,0,0,5,0,0,0,0,0,0,0,0,0,0,0,0,0,0,0,0,0,0,0,0,5,0,0,5,0,0
0,0,0,0,0,5,0,0,0,0,0,0,0,0,0,0,0,0,0,0,0,0,0,0,0,0,0,0,0,5,0,0
0,0,0,0,0,5,0,0,0,0,0,0,0,0,0,0,0,0,0,0,0,0,0,0,0,0,0,0,0,5,0,0
0,0,0,0,0,5,0,0,0,0,0,0,0,0,0,0,0,0,0,0,0,0,0,0,0,0,0,0,0,5,0,0
0,0,0,0,0,5,0,0,0,0,0,0,0,0,0,0,0,0,0,0,0,0,0,0,0,0,0,0,0,5,0,0
8,8,8,8,8,8,8,8,8,8,8,8,8,8,8,8,8,8,8,8,8,8,8,8,8,8,8,8,8,8,8,8
8,8,8,8,8,8,8,8,8,8,8,8,8,8,8,8,8,8,8,8,8,8,8,8,8,8,8,8,8,8,8,8
